....?.+.
..++..?+
?+..?+..
.+.+....
?.++.+?+
.+++?+..
...+..+?
++...?..