....?.+.
..++..++
?+..?+..
.+.+....
?.++.+?+
.+++.+..
...++.+?
++...?..